##############
#      B     #
#            #
#            #
#            #
#            #
#            #
#            #
#            #
