##############
#.....B......#
#............#
#............#
#............#
#............#
#............#
#thisisupside#
#............#
#............#
#....down....#
#............#
#............#
#............#
#............#
##............#
#............#
##............#
###............##
#####............#
#####............#
######............#
#######............#
#######............#
######............#
#######............#
########............#
#########............#
##########............#
###########............#
############............###
##############.............#
##########################C#